00000000000000000000000000000000000000000000000000
00000000000000000000000000000000000000000000000000
00000000000000000000000000000000000000000000000000
00000000000000000000000000000000000000000000000000
00000000000000000101010000000101010000000000000000
00000000000000000101010000000101010000000000000000
00000000000000000101010000000101010000000000000000
00000000000000000000000000000000000000000000000000
00000000000000000000000001000000000000000000000000
00000000000000000000000001000000000000000000000000
00000000010101000000000001010000000001010100000000
00000000010001000000000000010000000001030100000000
00000000010001000000000101010000000001000100000000
00000000010001000000000000000000000001000100000000
00000000010001000000000000000000000001000100000000
00000000010001000000000000000000000001000100000000
00000000010001000000000000000000000001000100000000
00000000010001000000000000000000000001000100000000
00000000010001010101010101010101010101000100000000
00000000010000000000000000000000000000000100000000
00000000010101010101010101010101010101010100000000
00000000000000000000000000000000000000000000000000
00000000000000000000000000000000000000000000000000
00000000000000000000000000000000000000000000000000
00000000000000000000000000000000000000000000000000
0511
0
0
0
Hello!