01010000000000000000020102010200000000000000000000
00000000000000000000000200020000000000000000000000
00000000000000000000000000000000000000000000000001
00020102000000000000000200020000000000000000000002
00000000000000000000000100010000000000000000000001
00000000000000000000000200020002010200000000000001
00000000000000000000000100010000000000000000000002
00000000000000000000000200020000000000000000000001
00000000000000020000000000000000000000000000000000
00000000000000010000000000000000000000000000000000
00000000000000020000000200020000000000000201020000
00000000000000000000000000000000000000000000000000
00000201020000000000000200020000000200000000000000
00000000000000000000000000000000000100000000000002
00000000000000000000000000000000000200000000000001
00000000000000000000000200020000000000000000000002
00000000000000000000000100010000000000000000000000
00000000000000000000000200020000000000000000000000
00000000000000000000000100010000000000000000000000
00000000000000000000000200020000000000000000000000
00000200000000000000000000000000000000000000020000
00000100000000000000000000000000000000000000010000
00000200000000000000010201020100000000000000020000
00000000000000000000020103000000000000000000000000
00000000000000000000010201020100000000000000000101
1201
1
1
1
Lava!++