00000000000000000000000000000000000000000000000000
00000001000000000000000000000000000000000001000000
00000000000000000000000001000000000000000000000000
00010000000000000100000000000000010000000000000100
00000000000000000000000000000000000000000000000000
00000000000101010101010101010101010101010000000000
00000000000100000000000100010000000000010000000000
00000000000100010101000100010001010100010000000000
00000001000100010001000100010001000100010001000000
00000000000100010101000100010001010100010000000000
00000000000100000000000100010000000000010000000000
00000000000101010101010100010101010101010000000000
00000100000100000000000103000000000000010000010000
00000000000101010101010100010101010100010000000000
00000000000100000000000100010000000100010000000000
00000000000100010101000100010000000100010000000000
00000001000100010001000100010000000100010001000000
00000000000100010101000100010101010100010000000000
00000000000100000000000100000000000000010000000000
00000000000101010101010101010101010101010000000000
00000000000000000000000000000000000000000000000000
00010000000000010000000000000000010000000000000100
00000000000000000000000001000000000000000000000000
00000001000000000000000000000000000000000001000000
00000000000000000000000000000000000000000000000000
1206
1
1
1
 It's A Landing Pad